guojianmei@sjtu.edu.cn	Jianmei	Guo
wgxin@sjtu.edu.cn	Guangxin	Wang
li.jian@sjtu.edu.cn	Jian	Li
ylwang@sjtu.edu.cn	Yinglin	Wang
botherthing@126.com	Rong	Jin
shjjiang@cumt.edu.cn	Shujuan	Jiang
6211026@163.com	Hongchang	Zhang
changhainie@nju.edu.cn	Changhai	Nie
cshleung@inet.polyu.edu.hk	HARETON	LEUNG
wuzhiqiao@hotmail.com	ZHIQIAO	WU
jftang@mail.neu.edu.cn	JIAFU	TANG
mfckkong@polyu.edu.hk	C.K.	KWONG
mfcychan@polyu.edu.hk	C.Y.	CHAN
begin0000@qq.com	Zhenghua	Xin
huliangyi@126.com	Liangyi	Hu
lyl-49@163.com	Liang	Yalan
chenxiang@dislab.nju.edu.cn	Xiang	Chen
guq@nju.edu.cn	Qing	Gu
d948330@oz.nthu.edu.tw	Chao-Jung	Hsu
cyhuang@cs.nthu.edu.tw	Chin-Yu	Huang
czchenyong@163.com	Yong	Chen
zhongyong@cimslabsoft.com	Yong	Zhong
bk_he@126.com	Pei	He
kang_whu@yahoo.com	Lishan	Kang
huangsj@mail.ntust.edu.tw	Sun-Jen	Huang
jwt@hust.edu.cn	Sheng	Jiang
lys@hust.edu.cn	Yansheng	Lu
mayue@vl.com.cn	Yue	Ma
zcwbupt@sohu.com	Chengwen	Zhang
wangjunli_1029@163.com	Junli	Wang
ywangxd@gmail.com	Yan	Wang
baizhiwen@gmail.com	Zhiwen	Bai
emilia.zhang@gmail.com	Miao	Zhang
WenDuXD@gmail.com	Wen	Du
qinyingxd@gmail.com	Ying	Qin
xiyangliu@gmail.com	Xiyang	Liu
wangzai@mail.ustc.edu.cn	Zai	Wang
ketang@ustc.edu.cn	Ke	Tang
yinjingjie2008@yahoo.com.cn	Jingjie	Yin
zhonghao@pku.edu.cn	Hao	Zhong
zhanglu@sei.pku.edu.cn	Lu	Zhang
meih@pku.edu.cn	Hong	Mei
m944020010@student.nsysu.edu.tw	Chang-ming	Hsu
leiwangxd@gmail.com	Lei	Wang
xbzhuxd@gmail.com	Xiubin	Zhu
hehuiliu@gmail.com	Hehui	Liu
verdureview@yahoo.com.cn	Liu	Zhuang
hant_developer@163.com	Han	Tao
susen@bupt.edu.cn	Sen	Su
chjl@bupt.edu.cn	Junliang	Chen
zwjcbj2007@gmail.com	Chengwen	Zhang
yge@mail.zjgsu.edu.cn	Yujia	Ge
lijunshancn@yahoo.com	Lijun	Shan
stsheu@ce.ncu.edu.tw	Shiann-Tsong	Sheu
ouis_chuang@cameo.com.tw.	Yue-Ru	Chuang
lcao@cs.sjtu.edu.cn	Lei	Cao
cao-jian@cs.sjtu.edu.cn	Jian	Cao
li-ml@cs.sjtu.edu.cn	Minglu	Li
jianghe@dlut.edu.cn	He	Jiang
xuan@mail.dlut.edu.cn	Jifeng	Xuan
ren@mail.dlut.edu.cn	Zhilei	Ren
zhangjy019@hotmail.com	Jingyuan	Zhang
huyan@dlut.edu.cn	Yan	Hu
rlzhao@mail.buct.edu.cn	Ruilian	Zhao
z.li@ieee.org	Zheng	Li
y-cao@mails.tsinghua.edu.cn	Yang	Cao
huchuhua@tsinghua.edu.cn	Chunhua	Hu
lilm@tsinghua.edu.cn	Luming	Li
cetacy@mail.ustc.edu.cn	Tianshi	Chen
hfcheng4@163.com	Huifang	Cheng
yqzhang@hebeu.edu.cn	Yongqiang	Zhang
liyixuanmama@163.com	Jing	Zhao
gyy@mail.zjgsu.edu.cn	Yuanyan	Gu
bjiang@cs.hku.hk	Bo	Jiang
zyzhang@cs.hku.hk	Zhenyu	Zhang
wkchan@cs.cityu.edu.hk	W.K.	Chan
thtse@cs.hku.hk	T.H.	Tse
zhgxdylan@126.com	Gexiang	Zhang
wise.lou@163.com	Yuan-sheng	Lou
xqlin@bupt.edu.cn	Xiuqin	Lin
houss@sei.pku.edu.cn	Shan-Shan	Hou
guochao09@sei.pku.edu.cn	Chao	Guo
